121141311111111111111111
100001111100000000000111
100100000011111110000001
130000222220000220000001
100000001000000010000001
100000000000000000000001
100001110000011100001111
111000000000000000000001
100000000000000000000011
100000000000000000000011
100000000000000000000011
111111100000000000000001
100000000000000000000001
100000000000000000000001
100000000000000000000001
100000000000000000000001
100000000000000000000001
100000000000000000000001
100000000000000000000001
100000000000000000000001
100000000000000000000001
100000000000000000000001
111111111111111111111111
