+ + + + + + + + + + + + + + + + + + +
+ . . . . . . . . . . . . . . . . . +
+ . . . . . . . . . . . . . . . . . +
+ . . . . . . . . . . . . . . . . . +
+ . . . . . . . . . . . . . . . . . +
+ . . . . . . . . . . . . . . . . . +
+ . . . . . . . . . . . . . . . . . +
+ . . . . . . . . . . . . . . . . . +
+ . . . . . . . . . . . . . . . . . +
+ . . . . . . . . . . . + + . . . . +
+ . . . . . . . . . . . + + . . . . +
+ . . . . . . . . . . . . . . . . . +
+ . . . . . . . . . . . . . . . . . +
+ . . . . . . . . . . . . . . . . . +
+ + + + + + + + + + + + + + + + + + +
